NO ./texture/north.xpm
C 			120, 180, 255
F217, 170,             113


SO ./texture/south.xpm


		WE ./texture/west.xpm
DO ./texture/door.xpm
   SP ./texture/sprite/
EA ./texture/east.xpm

1111111
10000D1
1000001
1000001
10000N1
1111111

