1111111
1P000E1
10C0001
1111111