111111111111111
1P0C00E10000001
100000000000001
10C000C00C00001
100000000000001
100000000000001
100000000000001
100000000000001
100000000000011
1000000000000C1
111111111111111